#######
#@  $.#
#  #$##
# $..##
#######