#######
# @   #
# $$  #
# .#$ #
#..#  #
#######