##########
#@       #
# $   $  #
#### #####
   #$#    
 ### #### 
 #. .  .# 
 #      # 
 #      # 
 ########  