###########
########  #
#   $     # 
#   $   $ #
#   #### @#
#   ...####
###########     